


C      150,200,255


NO./textures/eagle.xpm

SO./textures/greystone.xpm
EA ./textures/red.xpm
F102,51,0 
WE             ./textures/kevadams.xpm       

11111
10N01
10001
11111
