C 255,20,30
F 0,255,0

NO ./textures/arp299_4k.xpm
SO ./textures/mj.xpm
EA ./textures/macron-calvitie.xpm
WE ./textures/kevadams.xpm

111111111111111111111
1N0000000000000000001
101010101011111110001
100010100010000010001
101110101111101011101
100000101000101000001
101111101011101111101
101000001010100000101
101011111010111110101
101010001010100010101
101110101010101010101
100000101010001010001
101111101011111011101
100000101000100010001
101110101110101110101
101000100000100010101
101011111111111010101
100010000000000010001
101010111011111111101
100000000000000000001
111111111111111111111
