C 255,20,30
F 0,0,0

NO ./textures/eagle.xpm
SO ./textures/eagle.xpm
EA ./textures/macron-calvitie.xpm
WE ./textures/macron-calvitie.xpm

111111111111111111111111111111
111111111000000000000000011111
100000000000000000111000100001
110011100000000000000000001111
10001 111111000000000000111111
1111111000000000W0000000000001
111100000000000000000000000011
111000000000000000000000000011
1 1000000000111000111110001111
1110000000001110001   10011
1110000000011110001   10001111
111111111111111111111111111111